/add/cross	Cross
/analyze/correlation	Qtl
/annotates/cvterms/rs	Genomes
/annotation/cvterms	Genomes
/assembly/cvterms	Genomes
/authenticate/user	AJAX
/blast/to/pcr	InSilicoPcr
/bs/sample/to/display/hashref	Genomes
/build//jsan/params	JavaScript
/build/feature/cache	Bulk
/build/gene/cache	Bulk
/build/jbrowse/url	AJAX
/build/schema	Search
/check/coordinates	AJAX
/check/user/login/accession/usage	AJAX
/check/user/login/accessions	AJAX
/check/user/login/analysis	AJAX
/check/user/login/analytics	AJAX
/check/user/login/breeders/toolbox	AJAX
/check/user/login/breedersearch	AJAX
/check/user/login/breederstoolbox/folder	AJAX
/check/user/login/breeding/program	AJAX
/check/user/login/calendar	AJAX
/check/user/login/catalog	AJAX
/check/user/login/company	AJAX
/check/user/login/cross	AJAX
/check/user/login/drone/imagery	AJAX
/check/user/login/drone/imagery/analytics	AJAX
/check/user/login/drone/imagery/main/display	AJAX
/check/user/login/drone/imagery/upload	DroneImagery
/check/user/login/drone/rover	AJAX
/check/user/login/drone/rover/main/display	AJAX
/check/user/login/drone/rover/upload	DroneRover
/check/user/login/file/share/dump	AJAX
/check/user/login/genotypes/vcf/upload	AJAX
/check/user/login/genotyping/data/project	AJAX
/check/user/login/genotyping/project	AJAX
/check/user/login/genotyping/protocol	AJAX
/check/user/login/genotyping/trial	AJAX
/check/user/login/graphicalfiltering	AJAX
/check/user/login/high/dim/pheno	AJAX
/check/user/login/html/select	AJAX
/check/user/login/image	Image
/check/user/login/image/analysis	AJAX
/check/user/login/image/search	AJAX
/check/user/login/location	AJAX
/check/user/login/nirs	AJAX
/check/user/login/population	AJAX
/check/user/login/seedlot	AJAX
/check/user/login/stock	AJAX
/check/user/login/tissue/sample	AJAX
/check/user/login/trial	AJAX
/check/user/login/trial/metadata	AJAX
/check/user/login/trials	AJAX
/child/phylonodes	Organism
/clean/inputs	AJAX
/correlation/output	Qtl
/cvtermprops	Cvterm
/draw/drone/imagery/section	AJAX
/draw/plot/polygon/images/panel	AJAX
/drone/imagery/interactive/get/gps	AJAX
/drone/imagery/match/and/align/images	AJAX
/feature/rs	Sequence
/feature/to/primaryseq	Sequence
/find/cgi/action	Redirects
/get/allowed/ONA/ODK/forms/from/lists	AJAX
/get/http/status/code	AJAX
/get/image/background/remove/threshold/percentage	AJAX
/get/owner/details	Qtl
/get/pedigree/children	AJAX
/get/pedigree/hash	AJAX
/get/pedigree/parents	AJAX
/get/pedigrees/from/file	AJAX
/get/private/company/from/project/id	AJAX
/get/relationships	AJAX
/get/standard/4/polygon/types	AJAX
/get/standard/9/polygon/types	AJAX
/get/standard/ndvi/ndre/polygon/types	AJAX
/get/stocks	Publication
/get/trait/acronyms	Qtl
/invalid/params	Bulk
/link	Qtl
/list/traits	Qtl
/load/user	Contact
/locus/pubs	Locus
/log/analysis/activity	AJAX
/make/head/post/html	Root
/make/head/pre/html	Root
/make/organism/search/rs	Search
/missing/field/response	AJAX
/new/cache/file	Bulk
/observationvariable/search/process	AJAX
/parse/design/from/json	AJAX
/parse/list/from/json	AJAX
/perform/autoencoder/keras/cnn/vi	AJAX
/perform/extended/base/standard/process	AJAX
/perform/extended/vi/standard/process	AJAX
/perform/fourier/transform/calculation	AJAX
/perform/gdd/calculation/and/drone/run/time/saving	AJAX
/perform/get/weeks/drone/run/after/planting	AJAX
/perform/image/background/remove/mask	AJAX
/perform/image/background/remove/threshold	AJAX
/perform/image/background/remove/threshold/percentage	AJAX
/perform/image/cropping	AJAX
/perform/image/denoise	AJAX
/perform/image/merge	AJAX
/perform/image/rotate	AJAX
/perform/keras/cnn/predict	AJAX
/perform/match/raw/images/sequential	AJAX
/perform/minimal/vi/standard/process	AJAX
/perform/phenotype/automated	AJAX
/perform/phenotype/calculation	AJAX
/perform/plot/polygon/assign	AJAX
/perform/precipitation/sum/calculation/and/drone/run/time/saving	AJAX
/perform/save/trained/keras/cnn/model	AJAX
/perform/standard/process/extended/vi/calc	AJAX
/perform/standard/process/minimal/vi/calc	AJAX
/perform/vegetative/index/calculation	AJAX
/prep/upload	AJAX
/process/clean/inputs	AJAX
/related/stock/images	Stock
/render/organism/tree	Organism
/resolve/jsan/dependencies	JavaScript
/reverse/complement	InSilicoPcr
/run/secretary	Project
/sample/search/process	AJAX
/search/signalp/file	Project
/show/data	Qtl
/species/summary/cache/configuration	Organism
/standard/response/construction	AJAX
/stock/editor/info	Stock
/stock/has/pedigree	Stock
/stock/images	Stock
/stock/owner/ids	Stock
/stockprops	Stock
/validate/pair	Stock
/validate/request	AJAX
/verify/cross	Cross
/write/cached/folder/tree	AJAX
AUTO	Blast
BUILD	Redirects
accession/autocomplete	AJAX
accession/autocomplete/GET	AJAX
accession/or/cross/autocomplete	AJAX
accession/or/cross/autocomplete/GET	AJAX
accession/population/autocomplete	AJAX
accession/population/autocomplete/GET	AJAX
accession/usage	Accession_usage
accession/usage/female	AJAX
accession/usage/male	AJAX
accession/usage/phenotypes	AJAX
accession/usage/trials	AJAX
accessions	AJAX
activity/stats	AJAX
add	Image
add/accession/list	AJAX
add/accession/list/POST	AJAX
add/accessions/to/population	AJAX
add/bulk	AJAX
add/cache/list	AJAX
add/catalog/item	AJAX
add/catalog/item/POST	AJAX
add/company	AJAX
add/company/POST	AJAX
add/company/member	AJAX
add/company/member/POST	AJAX
add/cross	AJAX
add/cross/POST	AJAX
add/cross/progeny	AJAX
add/crossingtrial	AJAX
add/crossingtrial/POST	AJAX
add/cvtermprop	AJAX
add/cvtermprop/POST	AJAX
add/data/agreement	AJAX
add/event	AJAX
add/event/POST	AJAX
add/genotyping/project	AJAX
add/genotyping/project/POST	AJAX
add/image/locus/display/order	AJAX
add/image/locus/display/order/GET	AJAX
add/image/locus/display/order/POST	AJAX
add/image/stock/display/order	AJAX
add/image/stock/display/order/GET	AJAX
add/image/stock/display/order/POST	AJAX
add/individual/cross	AJAX
add/item	AJAX
add/markerprop/GET	AJAX
add/member	AJAX
add/member/GET	AJAX
add/member/POST	AJAX
add/more/progeny	AJAX
add/person/role	AJAX
add/person/role/GET	AJAX
add/product/profile	AJAX
add/product/profile/POST	AJAX
add/seedlot/transaction	AJAX
add/sol100/organism	Organism
add/stock/parent	AJAX
add/stock/parent/GET	AJAX
add/stockprop	AJAX
add/stockprop/GET	AJAX
add/stockprop/POST	AJAX
ajax/analysis	AJAX
ajax/breeding/program	AJAX
all/ontology/terms/select	AJAX
all/qtl/traits	Qtl
all/types	AJAX
allelematrices	AJAX
allelematrices/GET	AJAX
allelematrices/POST	AJAX
allelematrices/cached	AJAX
allelematrices/cached/GET	AJAX
allelematrices/cached/POST	AJAX
allelematrices/new	AJAX
allelematrices/new/GET	AJAX
allelematrix	AJAX
allelematrix/GET	AJAX
allelematrix/POST	AJAX
allelematrix/search/process	AJAX
alt/index	Cview
analysis/detail	Analysis
analysis/model/delete	AJAX
analysis/model/detail	Analysis
analytics/protocol/detail	Analytics
analytics/protocols/compare/to/trait	AJAX
analytics/protocols/compare/to/trait/test/ar1/models	AJAX
analytics/protocols/merge/results	AJAX
analyze/trial/phenotypes	AJAX
annotation/index	Annotation
annotation/sets/for/organism	Genomes
annotation/updates	Annotation
api/v1/multi/sequence	Sequence
api/v1/single/sequence	Sequence
array/tab	Bulk
assemble/result	Search
assemblies/for/organism	Genomes
assembly/annotations	Genomes
assembly/files	Genomes
assign/owner	AJAX
assign/owner/GET	AJAX
assign/owner/POST	AJAX
associate/locus	AJAX
associate/locus/GET	AJAX
associate/locus/POST	AJAX
associate/ontology	AJAX
associate/ontology/GET	AJAX
associate/ontology/POST	AJAX
associate/parent/folder	AJAX
associate/unigene	AJAX
associate/unigene/POST	AJAX
attribute/detail	AJAX
attribute/detail/GET	AJAX
attribute/single	AJAX
attributes/retrieve	AJAX
attributes/save	AJAX
attributes/save/POST	AJAX
attributes/values/retrieve	AJAX
attributes/values/save	AJAX
attributes/values/save/POST	AJAX
authenticate	AJAX
authenticate/cookie	AJAX
authenticate/cookie/GET	AJAX
authenticate/v1/token	AJAX
authenticate/v1/token/DELETE	AJAX
authenticate/v1/token/GET	AJAX
authenticate/v1/token/POST	AJAX
authenticate/v2/token	AJAX
authenticate/v2/token/DELETE	AJAX
authenticate/v2/token/GET	AJAX
authenticate/v2/token/POST	AJAX
authorize/client	BrAPIClient
auto	Search
autocomplete	AJAX
autocomplete/GET	AJAX
available/lists	AJAX
available/marker/sets	AJAX
available/public/lists	AJAX
bac/end/tab	Bulk
bac/search	Search
barcode	Barcode
barcode/element	Barcode
barcode/image	Barcode
barcode/multitool	Barcode
barcode/preview	LabelDesigner
barcode/qrcode/jpg	Barcode
barcode/tempfile/jpg	Barcode
barcode/tool	Barcode
bare/mason	Root
basic/ajax/image	AJAX
basic/ajax/image/GET	AJAX
basic/ajax/image/POST	AJAX
basic/stats	AJAX
blast/help	Blast
boxplotter	BreedersToolbox
brapi	AJAX
breeder/download	BreedersToolbox
breeder/home	BreedersToolbox
breeder/search	BreedersToolbox
breedingmethods	AJAX
breedingmethods/GET	AJAX
build/accession/properties/info	BreedersToolbox
build/form	Search
bulk/download/stats	Bulk
bulk/feature	Bulk
bulk/feature/download	Bulk
bulk/feature/submit	Bulk
bulk/gene	Bulk
bulk/gene/download	Bulk
bulk/gene/submit	Bulk
bulk/gene/type/validate	Bulk
bulk/search	Search
buttons	Bulk
cache	AJAX
cache/GET	AJAX
cache/gene/sequences	Bulk
calendar/events/personal	AJAX
calendar/events/personal/GET	AJAX
calls	AJAX
calls/GET	AJAX
calls/search/retrieve	AJAX
calls/search/save	AJAX
calls/search/save/POST	AJAX
callsets	AJAX
callsets/GET	AJAX
callsets/call/detail	AJAX
callsets/call/detail/GET	AJAX
callsets/call/filter/detail	AJAX
callsets/call/filter/detail/GET	AJAX
callsets/fetch	AJAX
callsets/fetch/GET	AJAX
callsets/search/retrieve	AJAX
callsets/search/save	AJAX
callsets/search/save/POST	AJAX
callsets/single	AJAX
catalog/item/details	Catalog
cgi/action/for	CGI
change/account/info/action	AJAX
check	AJAX
check/maximum/standard/processes	AJAX
check/maximum/standard/processes/POST	AJAX
check/status	AJAX
check/user	AJAX
children	AJAX
children/GET	AJAX
choose/view	Feature
chr/sort	Stock
chromosome	Cview
clear/organism/tree	Organism
clone/tab	Bulk
code128/png	Barcode
color	AJAX
combine/lists	AJAX
common/traits/by/plot/list	AJAX
common/traits/by/plot/list/GET	AJAX
common/traits/by/trial/list	AJAX
common/traits/by/trial/list/GET	AJAX
common/traits/by/trials	AJAX
common/traits/by/trials/GET	AJAX
commoncropnames	AJAX
commoncropnames/GET	AJAX
company/page	Company
compose/trait	AJAX
compute/derive/traits	AJAX
confirm	Image
confirm/failure	User
confirm/user	User
continuous/scale	Barcode
continuous/scale/form	Barcode
controls/by/plot	AJAX
convert/sequences/to/bioperl/objects	Bulk
convert/stock/list	AJAX
converter/tab	Bulk
copy/public/list	AJAX
create	Primer3
create/DataCollector/spreadsheet	AJAX
create/DataCollector/spreadsheet/GET	AJAX
create/DataCollector/spreadsheet/POST	AJAX
create/cross/wishlist	AJAX
create/cross/wishlist/POST	AJAX
create/cross/wishlist/submit	AJAX
create/cross/wishlist/submit/POST	AJAX
create/entry/number/template	AJAX
create/fieldbook/from/trial	AJAX
create/fieldbook/from/trial/POST	AJAX
create/folder	AJAX
create/intercross/wishlist	AJAX
create/intercross/wishlist/POST	AJAX
create/jnlp	Interactomics
create/parents/file	AJAX
create/parents/file/POST	AJAX
create/phenotype/spreadsheet	AJAX
create/phenotype/spreadsheet/GET	AJAX
create/phenotype/spreadsheet/POST	AJAX
create/plant/plot/entries	AJAX
create/plant/subplot/entries	AJAX
create/plate/order	AJAX
create/plate/order/POST	AJAX
create/population	AJAX
create/profile/template	AJAX
create/profile/template/POST	AJAX
create/seedlot	AJAX
create/subplot/entries	AJAX
create/tissue/samples	AJAX
create/trait/file/for/field/book	AJAX
create/trait/file/for/field/book/POST	AJAX
create/wishlist/by/uploading	AJAX
create/wishlist/by/uploading/POST	AJAX
crops	AJAX
crops/GET	AJAX
cross/additional/info/trial	AJAX
cross/autocomplete	AJAX
cross/autocomplete/GET	AJAX
cross/detail	Cross
cross/female/parent/autocomplete	AJAX
cross/female/parent/autocomplete/GET	AJAX
cross/male/parent/autocomplete	AJAX
cross/male/parent/autocomplete/GET	AJAX
cross/progenies/trial	AJAX
cross/properties/trial	AJAX
cross/property/save	AJAX
cross/tool	Barcode
cross/wishlist/download	Cross
crosses	AJAX
crosses/GET	AJAX
crosses/POST	AJAX
crosses/and/details/in/trial	AJAX
crosses/in/crossingtrial	AJAX
crossing/trial/from/field/trial	AJAX
crossingproject/fetch	AJAX
crossingproject/fetch/GET	AJAX
crossingproject/fetch/PUT	AJAX
crossingproject/single	AJAX
crossingprojects	AJAX
crossingprojects/GET	AJAX
crossingprojects/POST	AJAX
csv/export/search	Search
data/is/private	Cview
dataset	Dataset
day/click/personal	AJAX
day/click/personal/GET	AJAX
dbinfo	Blast
dbstats	DbStats
debug	AJAX
default	Project
delete/all/crosses/in/crossingtrial	AJAX
delete/breeding/program	AJAX
delete/catalog/item	AJAX
delete/catalog/item/POST	AJAX
delete/cross	AJAX
delete/cross/POST	AJAX
delete/cvtermprop	AJAX
delete/cvtermprop/GET	AJAX
delete/dataset	AJAX
delete/event	AJAX
delete/event/POST	AJAX
delete/field/coord	AJAX
delete/file	FieldBook
delete/folder	AJAX
delete/genotyping/plate/from/field/trial/linkage	AJAX
delete/list/action	AJAX
delete/location	AJAX
delete/markerset	AJAX
delete/population	AJAX
delete/sequencing/info	AJAX
delete/single/assayed/trait	AJAX
delete/soil/data	AJAX
delete/soil/data/POST	AJAX
delete/stockprop	AJAX
delete/stockprop/GET	AJAX
delete/trial/data	AJAX
delete/trial/data/GET	AJAX
delete/uploaded/phenotype/files	AJAX
deserialize/image	AJAX
desynonymize/list	AJAX
directory/search	Search
disease/impact	Disease
disease/index	Disease
disease/links	Disease
disease/researchhighlights/index	Disease
disease/researchhighlights/kruse/2017	Disease
disease/researchhighlights/mann/2018	Disease
display/ids/notfound	Bulk
display/locusgroup/members	AJAX
display/locusgroup/members/GET	AJAX
display/ontologies	AJAX
display/ontologies/GET	AJAX
display/owners	AJAX
display/owners/GET	AJAX
display/page	Bulk
display/summary/page	Bulk
dna/tool	Barcode
do/exact/search	AJAX
do/fuzzy/search	AJAX
do/quick/search	QuickSearch
document/browser	DocumentBrowser
doi/banner	Publication
download	Bulk
download/accession/properties/action	BreedersToolbox
download/acronym	Qtl
download/action	BreedersToolbox
download/correlation	Qtl
download/cross/entries	Search
download/entry/number/template	AJAX
download/file	motifs_finder
download/gbs/action	BreedersToolbox
download/genotype	Qtl
download/genotypes	Stock
download/grm/action	BreedersToolbox
download/gwas/action	BreedersToolbox
download/list	AJAX
download/list/details	AJAX
download/md/file	Metadata
download/pdf/labels	StockBarcode
download/pedigree/action	BreedersToolbox
download/phenotype	Qtl
download/phenotypes	Stock
download/phenotypes/action	BreedersToolbox
download/qrcode	StockBarcode
download/release/file	ITAG
download/sequences	Sequence
download/static	Download
download/trial/qrcode	StockBarcode
downloaded/intercross/file/metadata	AJAX
drag/or/resize/event	AJAX
drag/or/resize/event/POST	AJAX
drone/imagery/accession/phenotype/histogram	AJAX
drone/imagery/accession/phenotype/histogram/GET	AJAX
drone/imagery/analysis/query	AJAX
drone/imagery/analysis/query/POST	AJAX
drone/imagery/apply/other/selected/vi	AJAX
drone/imagery/apply/other/selected/vi/POST	AJAX
drone/imagery/assign/plot/polygons	AJAX
drone/imagery/assign/plot/polygons/POST	AJAX
drone/imagery/autoencoder/keras/vi/model	AJAX
drone/imagery/autoencoder/keras/vi/model/POST	AJAX
drone/imagery/calculate/analytics	AJAX
drone/imagery/calculate/analytics/POST	AJAX
drone/imagery/calculate/fourier/transform	AJAX
drone/imagery/calculate/fourier/transform/POST	AJAX
drone/imagery/calculate/phenotypes	AJAX
drone/imagery/calculate/phenotypes/POST	AJAX
drone/imagery/calculate/statistics	AJAX
drone/imagery/calculate/statistics/POST	AJAX
drone/imagery/calculate/statistics/store/analysis	AJAX
drone/imagery/calculate/statistics/store/analysis/POST	AJAX
drone/imagery/calculate/vegetative/index	AJAX
drone/imagery/calculate/vegetative/index/POST	AJAX
drone/imagery/change/date/drone/run	AJAX
drone/imagery/change/date/drone/run/GET	AJAX
drone/imagery/check/associated/field/trials	AJAX
drone/imagery/check/associated/field/trials/GET	AJAX
drone/imagery/check/available/applicable/vi	AJAX
drone/imagery/check/available/applicable/vi/GET	AJAX
drone/imagery/check/gps/images/rotation	AJAX
drone/imagery/check/gps/images/rotation/POST	AJAX
drone/imagery/compare/images	AJAX
drone/imagery/compare/images/GET	AJAX
drone/imagery/crop/image	AJAX
drone/imagery/crop/image/POST	AJAX
drone/imagery/delete/drone/run	AJAX
drone/imagery/delete/drone/run/GET	AJAX
drone/imagery/delete/gps/images	AJAX
drone/imagery/delete/gps/images/POST	AJAX
drone/imagery/denoise	AJAX
drone/imagery/denoise/POST	AJAX
drone/imagery/export/drone/runs	AJAX
drone/imagery/export/drone/runs/GET	AJAX
drone/imagery/generate/phenotypes	AJAX
drone/imagery/generate/phenotypes/GET	AJAX
drone/imagery/get/contours	AJAX
drone/imagery/get/contours/GET	AJAX
drone/imagery/get/drone/run/image/counts	AJAX
drone/imagery/get/drone/run/image/counts/GET	AJAX
drone/imagery/get/gps	AJAX
drone/imagery/get/gps/GET	AJAX
drone/imagery/get/image	AJAX
drone/imagery/get/image/GET	AJAX
drone/imagery/get/image/for/saving/gcp	AJAX
drone/imagery/get/image/for/saving/gcp/GET	AJAX
drone/imagery/get/image/for/time/series	AJAX
drone/imagery/get/image/for/time/series/GET	AJAX
drone/imagery/get/image/types	AJAX
drone/imagery/get/image/types/GET	AJAX
drone/imagery/get/plot/polygon/images	AJAX
drone/imagery/get/plot/polygon/images/GET	AJAX
drone/imagery/get/vehicle	AJAX
drone/imagery/get/vehicle/GET	AJAX
drone/imagery/get/vehicles	AJAX
drone/imagery/get/vehicles/GET	AJAX
drone/imagery/growing/degree/days	AJAX
drone/imagery/growing/degree/days/GET	AJAX
drone/imagery/manual/assign/plot/polygon	AJAX
drone/imagery/manual/assign/plot/polygon/POST	AJAX
drone/imagery/manual/assign/plot/polygon/save/partial/template	AJAX
drone/imagery/manual/assign/plot/polygon/save/partial/template/POST	AJAX
drone/imagery/mask/remove/background	AJAX
drone/imagery/mask/remove/background/POST	AJAX
drone/imagery/match/and/align/images/sequential	AJAX
drone/imagery/match/and/align/images/sequential/POST	AJAX
drone/imagery/match/and/align/two/images	AJAX
drone/imagery/match/and/align/two/images/POST	AJAX
drone/imagery/merge/bands	AJAX
drone/imagery/merge/bands/POST	AJAX
drone/imagery/obsolete/image/change	AJAX
drone/imagery/obsolete/image/change/GET	AJAX
drone/imagery/plot/polygon/spreadsheet/parse	AJAX
drone/imagery/plot/polygon/spreadsheet/parse/POST	AJAX
drone/imagery/point/cloud/3d	AJAX
drone/imagery/point/cloud/3d/POST	AJAX
drone/imagery/precipitation/sum	AJAX
drone/imagery/precipitation/sum/GET	AJAX
drone/imagery/predict/keras/model	AJAX
drone/imagery/predict/keras/model/POST	AJAX
drone/imagery/predict/mask/rcnn	AJAX
drone/imagery/predict/mask/rcnn/GET	AJAX
drone/imagery/quality/control/get/images	AJAX
drone/imagery/quality/control/get/images/GET	AJAX
drone/imagery/remove/background/display	AJAX
drone/imagery/remove/background/display/POST	AJAX
drone/imagery/remove/background/percentage/save	AJAX
drone/imagery/remove/background/percentage/save/POST	AJAX
drone/imagery/remove/background/save	AJAX
drone/imagery/remove/background/save/POST	AJAX
drone/imagery/remove/image	AJAX
drone/imagery/remove/image/GET	AJAX
drone/imagery/remove/one/gcp	AJAX
drone/imagery/remove/one/gcp/POST	AJAX
drone/imagery/retrain/mask/rcnn	AJAX
drone/imagery/retrain/mask/rcnn/GET	AJAX
drone/imagery/retrieve/parameter/template	AJAX
drone/imagery/retrieve/parameter/template/GET	AJAX
drone/imagery/rotate/image	AJAX
drone/imagery/rotate/image/POST	AJAX
drone/imagery/save/associated/field/trials	AJAX
drone/imagery/save/associated/field/trials/GET	AJAX
drone/imagery/save/gps/images	AJAX
drone/imagery/save/gps/images/POST	AJAX
drone/imagery/save/keras/model	AJAX
drone/imagery/save/keras/model/GET	AJAX
drone/imagery/save/plot/polygons/template	AJAX
drone/imagery/save/plot/polygons/template/POST	AJAX
drone/imagery/save/plot/polygons/template/separated	AJAX
drone/imagery/save/plot/polygons/template/separated/POST	AJAX
drone/imagery/save/single/plot/image	AJAX
drone/imagery/save/single/plot/image/POST	AJAX
drone/imagery/saving/gcp	AJAX
drone/imagery/saving/gcp/POST	AJAX
drone/imagery/separate/gps	AJAX
drone/imagery/separate/gps/GET	AJAX
drone/imagery/show/example/simulations	AJAX
drone/imagery/show/example/simulations/POST	AJAX
drone/imagery/train/keras/model	AJAX
drone/imagery/train/keras/model/POST	AJAX
drone/imagery/update/details	AJAX
drone/imagery/update/details/POST	AJAX
drone/imagery/update/gps/images/rotation	AJAX
drone/imagery/update/gps/images/rotation/POST	AJAX
drone/rover/collections/field/names	AJAX
drone/rover/collections/field/names/GET	AJAX
drone/rover/collections/field/names/link	AJAX
drone/rover/collections/field/names/link/POST	AJAX
drone/rover/get/collection	AJAX
drone/rover/get/collection/GET	AJAX
drone/rover/get/point/cloud	AJAX
drone/rover/get/point/cloud/POST	AJAX
drone/rover/get/vehicles	AJAX
drone/rover/get/vehicles/GET	AJAX
drone/rover/plot/polygons/process/apply	AJAX
drone/rover/plot/polygons/process/apply/POST	AJAX
drone/rover/plot/polygons/test/pheno/range/correlations	AJAX
drone/rover/plot/polygons/test/pheno/range/correlations/POST	AJAX
drone/rover/summary/top	AJAX
drone/rover/summary/top/GET	AJAX
drone/run/get/field/trial/drone/run/projects/in/same/orthophoto	AJAX
drone/run/get/field/trial/drone/run/projects/in/same/orthophoto/GET	AJAX
dumptextfile	Bulk
edit/catalog/image	AJAX
edit/catalog/image/POST	AJAX
edit/company	AJAX
edit/company/POST	AJAX
edit/company/member	AJAX
edit/company/member/POST	AJAX
edit/event	AJAX
edit/event/POST	AJAX
edit/management/factor/details	AJAX
edit/seedlot/transaction	AJAX
end	Root
epg/george/acp/2018	EPG
epg/index	EPG
est/search	Search
ethz/cass/sync	Static
events/search	AJAX
events/search/GET	AJAX
events/search/POST	AJAX
events/search/process	AJAX
evidence	AJAX
evidence/GET	AJAX
evidence/description	AJAX
evidence/description/GET	AJAX
evidences	AJAX
evidences/GET	AJAX
execute/predefined/searches	QuickSearch
exists/item	AJAX
exists/item/action	AJAX
exists/list/action	AJAX
experiment/search	Search
expression/atlas	ExpressionTool
extract/trait/data	AJAX
family/name/autocomplete	AJAX
family/name/autocomplete/GET	AJAX
family/name/detail	Cross
family/search	Search
feature/details	Feature
feature/search	AJAX
feature/type/autocomplete	Search
feature/xrefs	SiteFeatures
featureprop/type/autocomplete	Search
fetch/sequences	Sequence
field/book	FieldBook
field/trial/from/field/trial	AJAX
fieldmap	BreedersToolbox
filesharedump/list	AJAX
filesharedump/list/GET	AJAX
filesharedump/upload	AJAX
filesharedump/upload/POST	AJAX
filter/by/list/items	AJAX
filter/qtl/traits	Qtl
find/organism	Organism
find/redirect	Redirects
flatten/node	AJAX
folder/page	Folder
forgot/username	AJAX
form	KinaseClones
format/response	AJAX
format/search/args	Search
format/sequencing/infos	AJAX
freeze/sequences	Bulk
ftp/tab	Bulk
fuzzy/response/download	AJAX
fuzzy/response/download/POST	AJAX
fuzzysearch	AJAX
gbs/qc/action	BreedersToolbox
gene/tab	Bulk
generate/barcode	Barcode
generate/experimental/design	AJAX
generate/experimental/design/POST	AJAX
generate/genotype/trial	AJAX
generate/genotype/trial/POST	AJAX
generate/label/code	Barcode
generate/plot/phenotypes	AJAX
generate/predictions	AJAX
generate/predictions/POST	AJAX
generate/results	AJAX
generate/results/POST	AJAX
generate/sampling/trial	AJAX
generate/sampling/trial/POST	AJAX
generate/spectral/plot	AJAX
generate/spectral/plot/POST	AJAX
generate/unique/barcode/labels	Barcode
genetic/map	Qtl
genome/autocomplete	AJAX
genome/autocomplete/GET	AJAX
genotype	BrAPIClient
genotype/fetch	AJAX
genotype/fetch/GET	AJAX
genotype/fetch/POST	AJAX
genotyping/data/project/search	AJAX
genotyping/data/project/search/GET	AJAX
genotyping/data/project/search/page	Search
genotyping/data/search	AJAX
genotyping/data/search/GET	AJAX
genotyping/project/plates	AJAX
genotyping/project/plates/GET	AJAX
genotyping/protocol/delete	AJAX
genotyping/protocol/delete/GET	AJAX
genotyping/protocol/grm/genotype/relationships	AJAX
genotyping/protocol/grm/genotype/relationships/GET	AJAX
genotyping/protocol/grm/protocols/table	AJAX
genotyping/protocol/grm/protocols/table/GET	AJAX
genotyping/protocol/markers/search	AJAX
genotyping/protocol/markers/search/GET	AJAX
genotyping/protocol/pcr/markers	AJAX
genotyping/protocol/pcr/markers/GET	AJAX
genotyping/protocol/search	AJAX
genotyping/protocol/search/GET	AJAX
genotyping/protocol/search/page	Search
genotyping/trial/from/field/trial	AJAX
genotyping/trial/search/page	Search
geolocation/autocomplete	AJAX
geolocation/autocomplete/GET	AJAX
germplasm	AJAX
germplasm/GET	AJAX
germplasm/POST	AJAX
germplasm/attribute/categories/list	AJAX
germplasm/attribute/categories/list/GET	AJAX
germplasm/attributes/detail	AJAX
germplasm/attributes/detail/GET	AJAX
germplasm/attributes/list	AJAX
germplasm/attributes/list/GET	AJAX
germplasm/attributes/process	AJAX
germplasm/attributes/values	AJAX
germplasm/attributes/values/GET	AJAX
germplasm/attributes/values/detail	AJAX
germplasm/attributes/values/detail/GET	AJAX
germplasm/attributes/values/single	AJAX
germplasm/detail	AJAX
germplasm/detail/GET	AJAX
germplasm/detail/PUT	AJAX
germplasm/markerprofile	AJAX
germplasm/markerprofile/GET	AJAX
germplasm/markerprofile/POST	AJAX
germplasm/mcpd	AJAX
germplasm/mcpd/GET	AJAX
germplasm/pedigree	AJAX
germplasm/pedigree/GET	AJAX
germplasm/pedigree/POST	AJAX
germplasm/progeny	AJAX
germplasm/progeny/GET	AJAX
germplasm/progeny/POST	AJAX
germplasm/search/old	AJAX
germplasm/search/old/GET	AJAX
germplasm/search/old/POST	AJAX
germplasm/search/retrieve	AJAX
germplasm/search/save	AJAX
germplasm/search/save/POST	AJAX
germplasm/single	AJAX
get/BGPM/table	motifs_finder
get/accession/plots	AJAX
get/accessions/with/pedigree	AJAX
get/accessions/with/pedigree/GET	AJAX
get/activity/data	AJAX
get/additional/list/data	AJAX
get/all/derived/trait	AJAX
get/all/locations	AJAX
get/all/progenies	AJAX
get/all/sequenced/stocks	AJAX
get/all/soil/data	AJAX
get/all/trial/activities	AJAX
get/all/trial/types	AJAX
get/all/years	AJAX
get/analysis/models	AJAX
get/analytics/protocols	AJAX
get/annotated/loci	AJAX
get/annotated/stocks	AJAX
get/avg/phenotypes	AJAX
get/breeding/program	BreedingProgram
get/breeding/program/select	AJAX
get/breeding/programs/by/trial	AJAX
get/brighten/image	AJAX
get/brighten/image/GET	AJAX
get/catalog	AJAX
get/check/field/trial/ids	AJAX
get/check/field/trial/ids/GET	AJAX
get/chromosomes	AJAX
get/chromosomes/GET	AJAX
get/composable/cvs/allowed/combinations/select	AJAX
get/constraints	AJAX
get/cross/additional/info	AJAX
get/cross/parents	AJAX
get/cross/properties	AJAX
get/cross/relationships	AJAX
get/cross/tissue/culture/summary	AJAX
get/cross/transactions	AJAX
get/crosses	AJAX
get/crosses/select	AJAX
get/crossing/available/forms	AJAX
get/crossing/available/forms/GET	AJAX
get/crossing/available/wishlists	AJAX
get/crossing/available/wishlists/GET	AJAX
get/crossing/data	AJAX
get/crossing/data/GET	AJAX
get/crossing/data/cronjobs	AJAX
get/crossing/data/cronjobs/GET	AJAX
get/crossing/saved/ona/forms	AJAX
get/crossing/saved/ona/forms/GET	AJAX
get/cvterm	Cvterm
get/cvtermprops	AJAX
get/cvtermprops/GET	AJAX
get/data	AJAX
get/data/agreement	AJAX
get/dataset	AJAX
get/datasets/by/user	AJAX
get/datasets/by/user/html	AJAX
get/datasets/intersect/select	AJAX
get/datasets/public	AJAX
get/datasets/select	AJAX
get/dbxref/html	AJAX
get/direct/trials	AJAX
get/drone/imagery/drone/run/band	AJAX
get/drone/imagery/drone/runs	AJAX
get/drone/imagery/drone/runs/with/gcps	AJAX
get/drone/imagery/parameter/select	AJAX
get/drone/imagery/plot/polygon/types	AJAX
get/drone/run/band/projects	AJAX
get/drone/run/band/projects/GET	AJAX
get/drone/run/projects	AJAX
get/drone/run/projects/GET	AJAX
get/drone/run/projects/kv	AJAX
get/drone/run/projects/kv/GET	AJAX
get/entry/numbers	AJAX
get/expression/data	AJAX
get/expression/hash	AJAX
get/family/members	AJAX
get/family/parents	AJAX
get/feature	Feature
get/features	AJAX
get/female/accessions	AJAX
get/female/plants	AJAX
get/female/plots	AJAX
get/file/data	BreedersToolbox
get/folder	AJAX
get/freq/table	motifs_finder
get/full/pedigree	AJAX
get/full/pedigree/GET	AJAX
get/genefamily	Genefamily
get/genefamily/extended/info	Genefamily
get/genotyping/data/projects	AJAX
get/genotyping/data/projects/GET	AJAX
get/genotyping/data/protocols	AJAX
get/genotyping/data/protocols/GET	AJAX
get/genotyping/facilities/select	AJAX
get/genotyping/facility/select	AJAX
get/genotyping/protocol/chromosomes	AJAX
get/genotyping/protocol/select	AJAX
get/genotyping/trials/select	AJAX
get/genotypingserver/credentials	AJAX
get/group/and/member	AJAX
get/high/dimensional/phenotypes/protocols	AJAX
get/image/locus/display/order	AJAX
get/image/locus/display/order/GET	AJAX
get/image/stock/display/order	AJAX
get/image/stock/display/order/GET	AJAX
get/imaging/event/vehicles	AJAX
get/imaging/event/vehicles/rovers	AJAX
get/items/select	AJAX
get/js/module/dependencies	JavaScript
get/label/data/source/select	AJAX
get/list	AJAX
get/list/action	AJAX
get/list/data/action	AJAX
get/list/details	AJAX
get/list/metadata	AJAX
get/list/owner	AJAX
get/location/select	AJAX
get/locus	Locus
get/locus/dbxrefs	Locus
get/locus/extended/info	Locus
get/locus/owner/ids	Locus
get/locus/owner/objects	Locus
get/login/button/html	AJAX
get/male/accessions	AJAX
get/male/plants	AJAX
get/male/plots	AJAX
get/maps	AJAX
get/maps/GET	AJAX
get/markerprops	AJAX
get/markerprops/GET	AJAX
get/markerset/items	AJAX
get/markerset/type	AJAX
get/md/file	Metadata
get/membership	AJAX
get/method	AJAX
get/micasense/aligned/raw/images	AJAX
get/micasense/aligned/raw/images/grid	AJAX
get/noaa/station/id	AJAX
get/odk/cross/progress/cached	AJAX
get/odk/cross/progress/cached/GET	AJAX
get/odk/cross/summary/cached	AJAX
get/odk/cross/summary/cached/GET	AJAX
get/ontologies	AJAX
get/organism/metadata/props	AJAX
get/organism/set	Organism
get/organism/tree	Organism
get/parameters	Bulk
get/parentage	Organism
get/pedigree/string	AJAX
get/pedigree/string/	AJAX
get/phenotyped/stocks	AJAX
get/phenotyped/trait/components/select	AJAX
get/phenotypes/by/stock/and/trial	AJAX
get/phenotyping/data	AJAX
get/phenotyping/data/GET	AJAX
get/plot/image/sizes	AJAX
get/plot/polygon/templates/partial	AJAX
get/plot/polygon/types	AJAX
get/plot/polygon/types/GET	AJAX
get/plot/polygon/types/images	AJAX
get/plot/polygon/types/images/GET	AJAX
get/private/companies/select	AJAX
get/prob/table	motifs_finder
get/product/profiles	AJAX
get/profile/detail	AJAX
get/progenies	AJAX
get/project/md/image	AJAX
get/project/md/image/GET	AJAX
get/projects/select	AJAX
get/protein/sequences	Feature
get/protocols	AJAX
get/protocols/GET	AJAX
get/pub	Publication
get/related/mapped/markers	AJAX
get/related/mapped/markers/GET	AJAX
get/related/variants	AJAX
get/related/variants/GET	AJAX
get/related/variants/of/mapped/marker	AJAX
get/related/variants/of/mapped/marker/GET	AJAX
get/relationships	AJAX
get/relationships/POST	AJAX
get/release	ITAG
get/result	AJAX
get/result/table	motifs_finder
get/roles	AJAX
get/sample	Biosource
get/sample/files	Biosource
get/sample/targets	Biosource
get/seedlots/select	AJAX
get/sequence/metadata/protocols	AJAX
get/sequencing/info	AJAX
get/sequencing/info/for/stock	AJAX
get/siblings	AJAX
get/spatial/layout	AJAX
get/specific/data	Feature
get/stock	Stock
get/stock/datatables/genotype/data	AJAX
get/stock/datatables/genotype/data/GET	AJAX
get/stock/extended/info	Stock
get/stock/for/tissue	AJAX
get/stock/has/pedigree	Stock
get/stock/owner/ids	Stock
get/stock/trait/list	AJAX
get/stock/trials	AJAX
get/stockprops	AJAX
get/stockprops/GET	AJAX
get/stocks/select	AJAX
get/stocks/using/markerset	AJAX
get/sum/indv/table	motifs_finder
get/suppress/plot/phenotype	AJAX
get/synonyms	AJAX
get/taxa/choices	Search
get/template	Qtl
get/trained/keras/cnn/models	AJAX
get/trained/keras/mask/r/cnn/models	AJAX
get/trained/nirs/models	AJAX
get/trait/components/select	AJAX
get/trait/from/exact/components	AJAX
get/traits/from/component/categories	AJAX
get/traits/select	AJAX
get/treatments/select	AJAX
get/trial/additional/file/uploaded	AJAX
get/trial/design	AJAX
get/trial/folder	AJAX
get/trial/folder/select	AJAX
get/trial/from/stock/list	AJAX
get/trial/location	AJAX
get/trial/related/stock	AJAX
get/trial/type	AJAX
get/trial/type/select	AJAX
get/trials	AJAX
get/trials/select	AJAX
get/trials/with/folders	AJAX
get/trials/with/folders/cached	AJAX
get/type/action	AJAX
get/type/specific/data	Feature
get/types	AJAX
get/user	AJAX
get/user/completed/orders	AJAX
get/user/current/orders	AJAX
get/variant/chromosomes	AJAX
get/variant/protocols	AJAX
get/variant/reference/genomes	AJAX
get/vendor/completed/orders	AJAX
get/vendor/current/orders	AJAX
get/week/after/planting/date	AJAX
get/week/after/planting/date/GET	AJAX
get/year/select	AJAX
getFileLines	Bulk
glossary	Search
gmodrpc/fetch/seq	Sequence
google/search	QuickSearch
graphical/filtering	BreedersToolbox
hash2param	AJAX
help	Help
help/section	Help
high/dimensional/phenotypes/download/file	AJAX
high/dimensional/phenotypes/download/file/POST	AJAX
high/dimensional/phenotypes/download/relationship/matrix/file	AJAX
high/dimensional/phenotypes/download/relationship/matrix/file/POST	AJAX
high/dimensional/phenotypes/metabolomics/upload/store	AJAX
high/dimensional/phenotypes/metabolomics/upload/store/POST	AJAX
high/dimensional/phenotypes/metabolomics/upload/verify	AJAX
high/dimensional/phenotypes/metabolomics/upload/verify/POST	AJAX
high/dimensional/phenotypes/nirs/upload/store	AJAX
high/dimensional/phenotypes/nirs/upload/store/POST	AJAX
high/dimensional/phenotypes/nirs/upload/verify	AJAX
high/dimensional/phenotypes/nirs/upload/verify/POST	AJAX
high/dimensional/phenotypes/transcriptomics/upload/store	AJAX
high/dimensional/phenotypes/transcriptomics/upload/store/POST	AJAX
high/dimensional/phenotypes/transcriptomics/upload/verify	AJAX
high/dimensional/phenotypes/transcriptomics/upload/verify/POST	AJAX
home	BrAPIClient
identifier/generation/download	AJAX
identifier/generation/history	AJAX
identifier/generation/list	AJAX
image/analysis/group	AJAX
image/analysis/group/POST	AJAX
image/analysis/submit	AJAX
image/analysis/submit/POST	AJAX
image/content/store	AJAX
image/content/store/PUT	AJAX
image/display/order	Image
image/info	AJAX
image/info/GET	AJAX
image/locus/connection	AJAX
image/locus/connection/GET	AJAX
image/locus/connection/POST	AJAX
image/search	AJAX
image/search/retrieve	AJAX
image/search/save	AJAX
image/search/save/POST	AJAX
image/stock/connection	AJAX
image/stock/connection/GET	AJAX
image/stock/connection/POST	AJAX
images	AJAX
images/GET	AJAX
images/POST	AJAX
images/by/id	AJAX
images/search	Search
images/single	AJAX
images/single/GET	AJAX
images/single/PUT	AJAX
index	Project
input	VigsTool
insert/collected/html	Root
insert/element	AJAX
instructions	Project
interactive/barcoder/main	LabelDesigner
interactomics	Interactomics
intersect/lists	AJAX
invalidate/organism/tree/cache	Organism
is/logged/in	AJAX
is/perl/cgi	CGI
is/qtl/pop	Qtl
item/image/list	AJAX
jobid/to/file	AJAX
label/designer/download	AJAX
label/designer/download/GET	AJAX
label/designer/download/POST	AJAX
label/to/page	StockBarcode
legacy	JavaScript
library/search	Search
list/all/uploads	Static
list/analyses/by/model/table	AJAX
list/analyses/by/user/table	AJAX
list/analyses/models/by/user/table	AJAX
list/analytics/protocols/by/user/table	AJAX
list/analytics/protocols/result/files	AJAX
list/cross/wishlists	AJAX
list/cross/wishlists/GET	AJAX
list/databases	AJAX
list/databases/GET	AJAX
list/detail	AJAX
list/detail/GET	AJAX
list/detail/PUT	AJAX
list/details	List
list/genomes	Genomes
list/items	AJAX
list/items/POST	AJAX
list/release/files	ITAG
list/releases	ITAG
list/search/retrieve	AJAX
list/search/save	AJAX
list/search/save/POST	AJAX
list/seedlot/transactions	AJAX
list/seedlots	AJAX
list/single	AJAX
list/size	AJAX
list/test	Static
lists	AJAX
lists/GET	AJAX
lists/POST	AJAX
locations/detail	AJAX
locations/detail/GET	AJAX
locations/detail/PUT	AJAX
locations/list	AJAX
locations/list/GET	AJAX
locations/list/POST	AJAX
locations/search/retrieve	AJAX
locations/search/save	AJAX
locations/search/save/POST	AJAX
locus/dbxrefs/by/db	Locus
locus/network	AJAX
locus/network/GET	AJAX
locus/relationships	AJAX
locus/relationships/GET	AJAX
locus/search	AJAX
locus/unigenes	AJAX
locus/unigenes/GET	AJAX
log/in	AJAX
log/out	AJAX
login	AJAX
login/status	SiteStatus
logout	AJAX
make/cross	Cross
make/cross/form	Cross
make/feature/search/rs	Search
make/private/list	AJAX
make/public/list	AJAX
manage/accessions	BreedersToolbox
manage/breeding/programs	BreedersToolbox
manage/crosses	BreedersToolbox
manage/drone/imagery	BreedersToolbox
manage/drone/rover	BreedersToolbox
manage/drone/rover/plot/polygon/process	BreedersToolbox
manage/file/share/dump	BreedersToolbox
manage/genotype/qc	BreedersToolbox
manage/genotyping	BreedersToolbox
manage/identifier/generation	BreedersToolbox
manage/locations	BreedersToolbox
manage/markers	BreedersToolbox
manage/nirs	BreedersToolbox
manage/nurseries	BreedersToolbox
manage/odk/data/collection	BreedersToolbox
manage/phenotyping	BreedersToolbox
manage/phenotyping/download	BreedersToolbox
manage/phenotyping/view	BreedersToolbox
manage/plot/phenotyping	BreedersToolbox
manage/point/cloud/visualization	BreedersToolbox
manage/private/companies	BreedersToolbox
manage/roles	BreedersToolbox
manage/sequence/metadata	SequenceMetadata
manage/tissue/samples	BreedersToolbox
manage/trial/phenotyping	BreedersToolbox
manage/trials	BreedersToolbox
manage/upload	BreedersToolbox
map	Cview
map/data	Organism
map/qtl/traits	Qtl
map/submission	Cview
maps	Cview
maps/details	AJAX
maps/details/GET	AJAX
maps/details/POST	AJAX
maps/list	AJAX
maps/list/GET	AJAX
maps/list/POST	AJAX
maps/marker/detail	AJAX
maps/marker/detail/GET	AJAX
maps/marker/detail/POST	AJAX
maps/marker/detail/lg	AJAX
maps/marker/detail/lg/GET	AJAX
maps/marker/linkagegroup/detail	AJAX
maps/marker/linkagegroup/detail/GET	AJAX
maps/markerpositions	AJAX
maps/markerpositions/GET	AJAX
maps/markerpositions/retrieve	AJAX
maps/markerpositions/save	AJAX
maps/markerpositions/save/POST	AJAX
maps/single	AJAX
mark/qtl/traits	Qtl
marker/search	Search
markerprofile/search/process	AJAX
markerprofiles/list	AJAX
markerprofiles/list/GET	AJAX
markerprofiles/list/POST	AJAX
markerprofiles/methods	AJAX
markerprofiles/single	AJAX
markers/search	AJAX
markers/search/GET	AJAX
markers/search/retrieve	AJAX
markers/search/save	AJAX
markers/search/save/POST	AJAX
mason/forward	Static
mason/forward/with/subfolder	Static
match	AJAX
match/GET	AJAX
menu	AJAX
menu/GET	AJAX
metabolomics	AJAX
metabolomics/GET	AJAX
metabolomics/detail	AJAX
metabolomics/detail/GET	AJAX
metabolomics/host/chin/csinensis/2019	MetabolomicsHost
metabolomics/host/index	MetabolomicsHost
metabolomics/host/ramsey/climon/2019	MetabolomicsHost
metabolomics/matrix	AJAX
metabolomics/matrix/GET	AJAX
metabolomics/single	AJAX
metadata/barcodes	Barcode
metadata/form	AJAX
metadata/static	AJAX
microtomography/cicero/alimentarycanal/2018	Microtomography
microtomography/cicero/stylet/2018	Microtomography
microtomography/index	Microtomography
microtomography/javier/bruker/2017	Microtomography
mixed/model/index	MixedModels
model/string	AJAX
name/var	motifs_finder
new/account	AJAX
new/barcode/tool	Barcode
new/database	AJAX
new/database/GET	AJAX
new/identifier/generation	AJAX
new/jsan	JavaScript
new/list	AJAX
new/list/action	AJAX
new/locus	Locus
new/pub	Publication
new/stock	Stock
new/user	User
newSearchButton	Bulk
nextButton	Bulk
nirs	AJAX
nirs/GET	AJAX
nirs/detail	AJAX
nirs/detail/GET	AJAX
nirs/matrix	AJAX
nirs/matrix/GET	AJAX
nirs/single	AJAX
no/data/error/page	Bulk
noaa/ncdc/analysis	AJAX
noaa/ncdc/gdd/cp	AJAX
observation/levels	AJAX
observation/levels/GET	AJAX
observation/search/retrieve	AJAX
observation/search/save	AJAX
observation/search/save/POST	AJAX
observation/tables/search/retrieve	AJAX
observation/tables/search/save	AJAX
observation/tables/search/save/POST	AJAX
observation/unit/single	AJAX
observation/unit/single/GET	AJAX
observation/unit/single/PUT	AJAX
observation/units	AJAX
observation/units/GET	AJAX
observation/units/POST	AJAX
observation/units/PUT	AJAX
observation/units/search/retrieve	AJAX
observation/units/search/save	AJAX
observation/units/search/save/POST	AJAX
observation/units/table	AJAX
observation/units/table/GET	AJAX
observations	AJAX
observations/GET	AJAX
observations/POST	AJAX
observations/PUT	AJAX
observations/detail	AJAX
observations/detail/GET	AJAX
observations/detail/PUT	AJAX
observations/search	AJAX
observations/search/GET	AJAX
observations/search/POST	AJAX
observations/search/process	AJAX
observations/single	AJAX
observations/table	AJAX
observations/table/GET	AJAX
observationvariable/data/type/list	AJAX
observationvariable/data/type/list/GET	AJAX
observationvariable/data/type/list/POST	AJAX
observationvariable/detail	AJAX
observationvariable/detail/GET	AJAX
observationvariable/list	AJAX
observationvariable/list/GET	AJAX
observationvariable/list/POST	AJAX
observationvariable/ontologies	AJAX
observationvariable/ontologies/GET	AJAX
observationvariable/ontologies/POST	AJAX
observationvariable/search	AJAX
observationvariable/search/GET	AJAX
observationvariable/search/POST	AJAX
obsolete/locus/unigene	AJAX
obsolete/locus/unigene/POST	AJAX
obsolete/locusgroup/member	AJAX
obsolete/locusgroup/member/POST	AJAX
obsolete/trial/additional/file/uploaded	AJAX
old/direct/search	Search
old/trial/url	BreedersToolbox
oldsearch	Search
onto/browser	Ontology
ontology/children/select	AJAX
openid/configuration	OpenidConfiguration
order/details	Order
order/stocks	Order
organism/tree/image	Organism
organisms	AJAX
organisms/GET	AJAX
output/list	Bulk
padtrunc	Project
parents	AJAX
parents/GET	AJAX
parse/genotype/trial/file	AJAX
parse/genotype/trial/file/POST	AJAX
parse/sampling/trial/file	AJAX
parse/sampling/trial/file/POST	AJAX
pcr/genotyping/data/download	AJAX
pcr/genotyping/data/download/POST	AJAX
pcr/genotyping/data/search	AJAX
pcr/genotyping/data/search/GET	AJAX
pcr/genotyping/data/summary/search	AJAX
pcr/genotyping/data/summary/search/GET	AJAX
pcr/protocol/genotype/data/download	GenotypeProtocol
pedigree/female/parent/autocomplete	AJAX
pedigree/female/parent/autocomplete/GET	AJAX
pedigree/male/parent/autocomplete	AJAX
pedigree/male/parent/autocomplete/GET	AJAX
people	AJAX
people/GET	AJAX
people/and/roles	AJAX
people/and/roles/GET	AJAX
people/detail	AJAX
people/detail/GET	AJAX
people/search	AJAX
people/search/retrieve	AJAX
people/search/save	AJAX
people/search/save/POST	AJAX
people/single	AJAX
people/top/level	People
phenotype	BrAPIClient
phenotype/data	Organism
phenotype/heatmap	AJAX
phenotype/select	Static
phenotype/summary	AJAX
phenotypes	AJAX
phenotypes/POST	AJAX
phenotypes/search	AJAX
phenotypes/search/GET	AJAX
phenotypes/search/POST	AJAX
phenotypes/search/csv	AJAX
phenotypes/search/csv/GET	AJAX
phenotypes/search/csv/POST	AJAX
phenotypes/search/table	AJAX
phenotypes/search/table/GET	AJAX
phenotypes/search/table/POST	AJAX
phenotypes/search/tsv	AJAX
phenotypes/search/tsv/GET	AJAX
phenotypes/search/tsv/POST	AJAX
phenotyping/handhelds	BrAPIClient
phenotyping/qrcode/jpg	Barcode
platform/search	Search
populate/gene/sequences	Bulk
population	Qtl
population/autocomplete	AJAX
population/autocomplete/GET	AJAX
population/members	AJAX
population/members/GET	AJAX
populations	AJAX
populations/GET	AJAX
possible/seedlots	AJAX
possible/seedlots/POST	AJAX
post/only	Bulk
prepare	AJAX
preview/plot/polygons	AJAX
preview/plot/polygons/POST	AJAX
previousButton	Bulk
process/authenticate/token	AJAX
process/authenticate/token/delete	AJAX
process/field	AJAX
process/input	Project
process/phenotypes/search/csv	AJAX
process/phenotypes/search/table	AJAX
process/phenotypes/search/tsv	AJAX
process/reset/password/form	AJAX
processed/plot/point/cloud/count	AJAX
processed/plot/point/cloud/count/GET	AJAX
profile/detail	BreedingProgram
program/crosses	AJAX
program/crossing/experiments	AJAX
program/field/trials	AJAX
program/genotyping/plates	AJAX
program/info	BreedingProgram
program/locations	AJAX
program/seedlots	AJAX
program/trials	AJAX
programs/detail	AJAX
programs/detail/GET	AJAX
programs/detail/PUT	AJAX
programs/list	AJAX
programs/list/GET	AJAX
programs/list/POST	AJAX
programs/search/retrieve	AJAX
programs/search/save	AJAX
programs/search/save/POST	AJAX
programs/single	AJAX
progress	AJAX
project/autocomplete	AJAX
project/autocomplete/GET	AJAX
project/metadata	AJAX
project/metadata/prop/list	AJAX
project/year/autocomplete	AJAX
project/year/autocomplete/GET	AJAX
projects/forward	Static
protein/sequence/fasta	Feature
protocol/page	GenotypeProtocol
pub/search	Publication
qrcode/png	Barcode
qtl/data	Organism
qtl/form	Qtl
qtl/populations	Organism
qtl/search	Search
qtl/traits	Qtl
query/mapped/markers	AJAX
query/mapped/markers/GET	AJAX
query/variants	AJAX
query/variants/GET	AJAX
quick/accession/search	QuickSearch
quick/array/search	QuickSearch
quick/automatic/annotation/search	QuickSearch
quick/bp/search	QuickSearch
quick/clone/search	QuickSearch
quick/create/account	User
quick/create/user	AJAX
quick/est/search	QuickSearch
quick/locations/search	QuickSearch
quick/manual/annotation/search	QuickSearch
quick/mapped/geno/marker/search	QuickSearch
quick/marker/search	QuickSearch
quick/page/search	QuickSearch
quick/phenotype/search	QuickSearch
quick/plot/search	QuickSearch
quick/populations/search	QuickSearch
quick/search	QuickSearch
quick/traits/search	QuickSearch
quick/trials/search	QuickSearch
quick/web/search	QuickSearch
raw/drone/imagery/drone/run/band/summary	AJAX
raw/drone/imagery/drone/run/band/summary/GET	AJAX
raw/drone/imagery/plot/image/count	AJAX
raw/drone/imagery/plot/image/count/GET	AJAX
raw/drone/imagery/summary/top	AJAX
raw/drone/imagery/summary/top/GET	AJAX
redirect/by/ident	QuickSearch
redirect/if/only/one/possible	QuickSearch
reference	AJAX
reference/GET	AJAX
reference/fetch	AJAX
reference/fetch/GET	AJAX
reference/search	AJAX
reference/search/POST	AJAX
reference/search/retrieve	AJAX
reference/single	AJAX
references	AJAX
references/GET	AJAX
referencesets	AJAX
referencesets/GET	AJAX
referencesets/fetch	AJAX
referencesets/fetch/GET	AJAX
referencesets/search	AJAX
referencesets/search/POST	AJAX
referencesets/search/retrieve	AJAX
referencesets/single	AJAX
refresh/matviews	AJAX
register	AJAX
register/POST	AJAX
relationships	AJAX
relationships/GET	AJAX
remove/company/member	AJAX
remove/company/member/POST	AJAX
remove/database	AJAX
remove/database/POST	AJAX
remove/element	AJAX
remove/element/action	AJAX
remove/parent/GET	AJAX
remove/person/role	AJAX
remove/person/role/POST	AJAX
remove/population/member	AJAX
remove/stock/parent	AJAX
rename/folder	AJAX
render	Root
render/canvas/graph	AJAX
render/fasta/page	Bulk
render/page	Dynamic
render/text/page	Bulk
replace/elements	AJAX
replace/plot/accession	AJAX
replace/trial/stock	AJAX
replace/well/accession	AJAX
reported/download	Download
require/logged/in	Image
reset/password	AJAX
reset/password/form	User
resolve/css/paths	Root
resolve/javascript/classes	JavaScript
result/file/to/hash	AJAX
results/variants	Search
retrieve/analysis/data	AJAX
retrieve/contents	AJAX
retrieve/list	AJAX
retrieve/longest/fields	AJAX
retrieve/phenotypes/csv	AJAX
retrieve/plot/image	AJAX
retrieve/plot/phenotype	AJAX
retrieve/plot/phenotype/POST	AJAX
retrieve/preview/plot/images	AJAX
retrieve/preview/plot/images/GET	AJAX
retrieve/results	AJAX
retrieve/trial/info	AJAX
retrieve/trial/info/POST	AJAX
roots	AJAX
roots/GET	AJAX
run	AJAX
run/bowtie2	AJAX
run/pcr/blast	InSilicoPcr
sample/details	AJAX
sample/details/GET	AJAX
sample/details/POST	AJAX
samples	AJAX
samples/GET	AJAX
samples/list	AJAX
samples/list/GET	AJAX
samples/list/POST	AJAX
samples/list/search	AJAX
samples/list/search/POST	AJAX
samples/list/search/retrieve	AJAX
samples/single	AJAX
save/experimental/design	AJAX
save/experimental/design/POST	AJAX
save/observation/results	AJAX
save/property/check	AJAX
save/results	AJAX
schedule/get/crossing/data	AJAX
schedule/get/crossing/data/GET	AJAX
search	AJAX
search/all/cross/entries	AJAX
search/common/parents	AJAX
search/cross/female/parents	AJAX
search/cross/male/parents	AJAX
search/crosses	AJAX
search/crosses/using/female	Search
search/crosses/using/male	Search
search/desc	AJAX
search/document	AJAX
search/document/POST	AJAX
search/gene/ids	AJAX
search/help	Qtl
search/index	Search
search/json	Search
search/page	Search
search/parameters	AJAX
search/parameters/GET	AJAX
search/pedigree/female/parents	AJAX
search/pedigree/male/parents	AJAX
search/progenies	AJAX
search/progenies/using/female	Search
search/progenies/using/male	Search
search/qtl/traits	Qtl
search/sequence/metadata	SequenceMetadata
search/stock	Stock
search/stocks/using/genotypes	Search
search/trial	BreedersToolbox
search/variants	Search
search/with/xrefs	QuickSearch
season/fetch	AJAX
season/fetch/GET	AJAX
season/search	AJAX
season/search/POST	AJAX
season/search/retrieve	AJAX
season/single	AJAX
seasons	AJAX
seasons/GET	AJAX
seasons/POST	AJAX
seasons/process	AJAX
seedlot/base	AJAX
seedlot/confirm/delete/by/list	AJAX
seedlot/delete	AJAX
seedlot/detail	Seedlot
seedlot/details	AJAX
seedlot/edit	AJAX
seedlot/name/autocomplete	AJAX
seedlot/name/autocomplete/GET	AJAX
seedlot/single	AJAX
seedlot/single/fetch	AJAX
seedlot/single/fetch/GET	AJAX
seedlot/single/fetch/PUT	AJAX
seedlot/single/transaction/fetch	AJAX
seedlot/single/transaction/fetch/GET	AJAX
seedlot/transaction/base	AJAX
seedlot/transaction/details	AJAX
seedlot/transactions	AJAX
seedlot/transactions/GET	AJAX
seedlot/transactions/POST	AJAX
seedlot/verify/delete/by/list	AJAX
seedlots	AJAX
seedlots/GET	AJAX
seedlots/POST	AJAX
seedlots/from/crossingtrial	AJAX
selection/index	BreedersToolbox
send/confirmation/email	AJAX
send/forgot/username/email/message	AJAX
send/reset/email/message	AJAX
sequence/metadata/query	AJAX
sequence/metadata/query/GET	AJAX
sequence/metadata/store	AJAX
sequence/metadata/store/POST	AJAX
sequence/metadata/upload/verify	AJAX
sequence/metadata/upload/verify/POST	AJAX
serialize/image	AJAX
serverinfo	AJAX
serverinfo/GET	AJAX
set/datasets/public	AJAX
set/download/headers	Download
set/folder/categories	AJAX
set/project/for/genotyping/plate	AJAX
set/project/for/genotyping/plate/POST	AJAX
set/stat/option	Qtl
set/tissue	AJAX
set/type	AJAX
sgn/events	Static
shared/phenotypes	AJAX
show/match/seq	Blast
show/search/results	Qtl
signalp/search	Project
signalp/search/csv	Project
sort/list/items	AJAX
sql/query/count	QuickSearch
srcfeatures/autocomplete	Search
standard/process/apply	AJAX
standard/process/apply/POST	AJAX
standard/process/apply/ground/control/points	AJAX
standard/process/apply/ground/control/points/POST	AJAX
standard/process/apply/previous/imaging/event	AJAX
standard/process/apply/previous/imaging/event/POST	AJAX
standard/process/apply/raw/images/interactive	AJAX
standard/process/apply/raw/images/interactive/POST	AJAX
standard/process/extended/apply	AJAX
standard/process/extended/apply/GET	AJAX
standard/process/minimal/vi/apply	AJAX
standard/process/minimal/vi/apply/POST	AJAX
stat/options/file	Qtl
status	Status
stock/autocomplete	AJAX
stock/autocomplete/GET	AJAX
stock/catalog	Catalog
stock/edit/details	AJAX
stock/edit/details/POST	AJAX
stock/lookup	AJAX
stock/lookup/POST	AJAX
stock/obsolete	AJAX
stock/obsolete/GET	AJAX
stock/search	AJAX
stockproperty/autocomplete	AJAX
stockproperty/autocomplete/GET	AJAX
stocks	AJAX
store	Image
store/analysis/json	AJAX
store/analysis/json/POST	AJAX
store/analysis/spreadsheet	AJAX
store/analysis/spreadsheet/POST	AJAX
store/barcode/output	StockBarcode
store/breeding/program	AJAX
store/data	AJAX
store/dataset	AJAX
store/generated/plot/phenotypes	AJAX
store/genotype/trial	AJAX
store/genotype/trial/POST	AJAX
store/location	AJAX
store/ontology/identifier	AJAX
store/plate/order	AJAX
store/plate/order/POST	AJAX
store/sampling/trial	AJAX
store/sampling/trial/POST	AJAX
store/sequencing/info	AJAX
store/trait/method/scale/observation/variable	AJAX
store/upload/existing/progenies	AJAX
studies	AJAX
studies/GET	AJAX
studies/POST	AJAX
studies/germplasm	AJAX
studies/germplasm/GET	AJAX
studies/germplasm/POST	AJAX
studies/info	AJAX
studies/info/GET	AJAX
studies/info/POST	AJAX
studies/info/PUT	AJAX
studies/layout	AJAX
studies/layout/GET	AJAX
studies/layout/POST	AJAX
studies/layouts	AJAX
studies/layouts/GET	AJAX
studies/observation/variables	AJAX
studies/observation/variables/GET	AJAX
studies/observation/variables/POST	AJAX
studies/observations	AJAX
studies/observations/GET	AJAX
studies/observations/granular	AJAX
studies/observations/granular/GET	AJAX
studies/observations/granular/PUT	AJAX
studies/search	AJAX
studies/search/GET	AJAX
studies/search/POST	AJAX
studies/search/retrieve	AJAX
studies/search/save	AJAX
studies/search/save/POST	AJAX
studies/single	AJAX
studies/table	AJAX
studies/table/GET	AJAX
study/types	AJAX
study/types/GET	AJAX
study/types/POST	AJAX
study/types/process	AJAX
submission/guide	Qtl
submission/guidelines	Phenotypes
submit	KinaseClones
submit/contact/form	AJAX
submit/contact/form/POST	AJAX
submit/order	AJAX
submit/order/POST	AJAX
substitute/stock	AJAX
summaryButton	Bulk
sync/cass/constructs	AJAX
sync/cass/constructs/POST	AJAX
sync/cass/transgenics	AJAX
sync/cass/transgenics/POST	AJAX
tablet/trait/file/download	FieldBook
ted	Static
temp/transform	AJAX
temp/validate	AJAX
template/search	Search
templates	Qtl
tempname	AJAX
test/authentication	Static
theme/template	Ambikon
tissue/sample/field/trials	AJAX
tissue/sample/field/trials/GET	AJAX
tissue/sample/genotyping/trials	AJAX
tissue/sample/genotyping/trials/GET	AJAX
tissue/sample/sampling/trials	AJAX
tissue/sample/sampling/trials/GET	AJAX
toggle/obsolete/annotation	AJAX
toggle/obsolete/annotation/POST	AJAX
toggle/public/list	AJAX
trait/autocomplete	AJAX
trait/autocomplete/GET	AJAX
trait/detail	AJAX
trait/detail/GET	AJAX
trait/histogram	AJAX
trait/info	BreedersToolbox
trait/phenotypes	AJAX
trait/search	Search
trait/search/page	Search
traits/assayed	AJAX
traits/list	AJAX
traits/list/GET	AJAX
traits/list/POST	AJAX
traits/measured	AJAX
traits/single	AJAX
transcript/data	Organism
transcriptomics	AJAX
transcriptomics/GET	AJAX
transcriptomics/detail	AJAX
transcriptomics/detail/GET	AJAX
transcriptomics/matrix	AJAX
transcriptomics/matrix/GET	AJAX
transcriptomics/single	AJAX
transform	AJAX
trial	AJAX
trial/accessions	AJAX
trial/accessions/rank	AJAX
trial/add/treatment	AJAX
trial/additional/file/upload	AJAX
trial/aerial/imaging/event/report/files	AJAX
trial/autocomplete	AJAX
trial/autocomplete/GET	AJAX
trial/calculate/numerical/derivative	AJAX
trial/change/plot/accessions/upload	AJAX
trial/comparison/input	BreedersToolbox
trial/comparison/params	BreedersToolbox
trial/completion/layout/section	AJAX
trial/completion/phenotype/section	AJAX
trial/controls	AJAX
trial/correlate/traits	AJAX
trial/design	AJAX
trial/details	AJAX
trial/details/GET	AJAX
trial/details/POST	AJAX
trial/download	BreedersToolbox
trial/download/log	BreedersToolbox
trial/field/book/download	FieldBook
trial/genotype/comparison	AJAX
trial/genotyping/protocol/grm/link	AJAX
trial/has/data/levels	AJAX
trial/has/plants	AJAX
trial/has/subplots	AJAX
trial/has/tissue/samples	AJAX
trial/info	BreedersToolbox
trial/init	BreedersToolbox
trial/layout	AJAX
trial/layout/table	AJAX
trial/lookup	AJAX
trial/phenotype/metadata	AJAX
trial/phenotypes/fully/uploaded	AJAX
trial/phenotypes/fully/uploaded/GET	AJAX
trial/phenotypes/fully/uploaded/POST	AJAX
trial/plants	AJAX
trial/plot/gps/delete	AJAX
trial/plot/gps/upload	AJAX
trial/plot/time/series/accessions	AJAX
trial/plots	AJAX
trial/qrcode/jpg	Barcode
trial/random/regression/correct/traits	AJAX
trial/search/page	Search
trial/seedlots	AJAX
trial/spatial/2dspl/correct/traits	AJAX
trial/stocks	AJAX
trial/subplots	AJAX
trial/tissue/samples	AJAX
trial/tissue/sources	AJAX
trial/treatments	AJAX
trial/tree	BreedersToolbox
trial/types	AJAX
trial/upload/phenotypes	AJAX
trial/upload/plants	AJAX
trial/upload/plants/subplot	AJAX
trial/upload/plants/subplot/with/index/number	AJAX
trial/upload/plants/subplot/with/number/of/plants	AJAX
trial/upload/plants/with/index/number	AJAX
trial/upload/plants/with/number/of/plants	AJAX
trial/upload/subplots	AJAX
trial/upload/subplots/with/index/number	AJAX
trial/upload/subplots/with/number/of/subplots	AJAX
trial/used/seedlots/upload	AJAX
trials/by/breeding/program	AJAX
trials/detail	AJAX
trials/detail/GET	AJAX
trials/detail/PUT	AJAX
trials/download/layouts	BreedersToolbox
trials/list	AJAX
trials/list/GET	AJAX
trials/list/POST	AJAX
trials/search/process	AJAX
trials/search/retrieve	AJAX
trials/search/save	AJAX
trials/search/save/POST	AJAX
trials/single	AJAX
type/autocomplete	Search
ug/build/selectbox	Bulk
unigene/search	Search
unigene/tab	Bulk
uniq/bs/samples	Genomes
update	Primer3
update/account	User
update/element/action	AJAX
update/list/description/action	AJAX
update/list/name/action	AJAX
update/order	AJAX
update/plot/phenotype	AJAX
update/plot/phenotype/POST	AJAX
update/trial/design/type	AJAX
update/trial/design/type/POST	AJAX
update/trial/status	AJAX
update/trial/status/POST	AJAX
upload/barcode/output	StockBarcode
upload/catalog/items	AJAX
upload/catalog/items/POST	AJAX
upload/cross	Cross
upload/cross/file	AJAX
upload/cross/file/POST	AJAX
upload/document	AJAX
upload/document/POST	AJAX
upload/drone/imagery	DroneImagery
upload/drone/imagery/POST	AJAX
upload/drone/imagery/additional/raw/images	DroneImagery
upload/drone/imagery/bulk	DroneImagery
upload/drone/imagery/bulk/previous	DroneImagery
upload/drone/imagery/check/drone/name	AJAX
upload/drone/imagery/check/drone/name/GET	AJAX
upload/drone/imagery/geocoordinate/param	DroneImagery
upload/drone/imagery/new/vehicle	AJAX
upload/drone/imagery/new/vehicle/POST	AJAX
upload/drone/imagery/new/vehicle/rover	AJAX
upload/drone/imagery/new/vehicle/rover/POST	AJAX
upload/drone/imagery/standard/process/previous/geotiff	DroneImagery
upload/drone/rover	DroneRover
upload/entry/number/template	AJAX
upload/entry/number/template/POST	AJAX
upload/expression/file/for/vigs	AJAX
upload/expression/file/for/vigs/POST	AJAX
upload/family/names	AJAX
upload/family/names/POST	AJAX
upload/genotype/qc/verify	AJAX
upload/genotype/qc/verify/POST	AJAX
upload/genotype/verify	AJAX
upload/genotype/verify/POST	AJAX
upload/info	AJAX
upload/info/POST	AJAX
upload/intercross/file	AJAX
upload/intercross/file/POST	AJAX
upload/locations	AJAX
upload/locations/POST	AJAX
upload/multiple/trial/designs/file	AJAX
upload/multiple/trial/designs/file/POST	AJAX
upload/pedigrees/store	AJAX
upload/pedigrees/verify	AJAX
upload/phenotype/store	AJAX
upload/phenotype/store/POST	AJAX
upload/phenotype/verify	AJAX
upload/phenotype/verify/POST	AJAX
upload/profile	AJAX
upload/profile/POST	AJAX
upload/progenies	AJAX
upload/progenies/POST	AJAX
upload/seedlots	AJAX
upload/seedlots/POST	AJAX
upload/seedlots/inventory	AJAX
upload/seedlots/inventory/POST	AJAX
upload/soil/data	AJAX
upload/soil/data/POST	AJAX
upload/ssr/protocol	AJAX
upload/ssr/protocol/POST	AJAX
upload/trial/coordinates	AJAX
upload/trial/file	AJAX
upload/trial/file/POST	AJAX
uploaded/intercross/file/metadata	AJAX
usage/policy	Static
validate	AJAX
validate/image/filename	Image
validate/upload/existing/progenies	AJAX
validate/upload/existing/progenies/POST	AJAX
variables/search/retrieve	AJAX
variables/search/save	AJAX
variables/search/save/POST	AJAX
variants/calls/detail	AJAX
variants/calls/detail/GET	AJAX
variants/calls/detail/POST	AJAX
variants/detail	AJAX
variants/detail/GET	AJAX
variants/search	AJAX
variants/search/GET	AJAX
variants/search/retrieve	AJAX
variants/search/save	AJAX
variants/search/save/POST	AJAX
variants/single	AJAX
variantsets	AJAX
variantsets/GET	AJAX
variantsets/calls/detail	AJAX
variantsets/calls/detail/GET	AJAX
variantsets/callset/detail	AJAX
variantsets/callset/detail/GET	AJAX
variantsets/extract	AJAX
variantsets/extract/POST	AJAX
variantsets/fetch	AJAX
variantsets/fetch/GET	AJAX
variantsets/search/retrieve	AJAX
variantsets/search/save	AJAX
variantsets/search/save/POST	AJAX
variantsets/single	AJAX
variantsets/variants/detail	AJAX
variantsets/variants/detail/GET	AJAX
verify/accession/list	AJAX
verify/accession/list/GET	AJAX
verify/accession/list/POST	AJAX
verify/accessions/file	AJAX
verify/accessions/file/POST	AJAX
verify/cross/list	AJAX
verify/cross/list/POST	AJAX
verify/family/name/list	AJAX
verify/family/name/list/POST	AJAX
verify/fuzzy/options	AJAX
verify/fuzzy/options/POST	AJAX
verify/name	AJAX
verify/name/GET	AJAX
verify/seedlot/list	AJAX
verify/seedlot/list/POST	AJAX
verify/stock/list	AJAX
verify/stock/list/POST	AJAX
verify/trial/name	AJAX
verify/trial/name/GET	AJAX
view	AJAX
view/all	Organism
view/all/uploads	AJAX
view/analyses	Analysis
view/analytics/protocols	Analytics
view/by/doi	Publication
view/by/name	Feature
view/by/organism/name	Stock
view/cvterm	Cvterm
view/genefamily	Genefamily
view/genome/data	Genomes
view/inbred/genome	Genomes
view/locus	Locus
view/organism	Organism
view/pub	Publication
view/sample	Biosource
view/sequenced/accessions	Genomes
view/sol100	Organism
view/stock	Stock
view/tomato/150	Genomes
view/tomato/360	Genomes
view/trial/by/name	BreedersToolbox
wellsort	BreedersToolbox
workflow	Styleguide
